This is a map message!
##########
#S.......#
#...##...#
#...##...#
#A...##..#
#....##..#
#....#B..#
#........#
#........#
#...C....#
##########
