Nao eh que nao pode, poder ninguem pode, mas todo mundo procura
####################
#.#S..............##
#.#####.#####.######
#.....#.....#.#....#
#####.#####.#.#.#.##
#.......#...#...#.##
#.#####.#########.C#
#.....#.........#.##
###.#.#########.#.##
#...#.....#...#....#
#.#######.#.#.#.#.##
#.#...#.....#.#..###
#.#.#.#####.####...#
#.#.#...#...#...#..#
#.#.###.#####.#.##.#
#...#.###.....#....#
#.###.#.#.##########
#A....#...........B#
####################
