Parabens, vc ganhou 0 segundos extras 
####################
#S#...............##
#.#.#############..#
#.#.#C....#...#...##
#.#.#.###.###.#.####
#.#.....#...#.....B#
#.#####.###.########
#...#...#.#.......##
###.#.###.#######.##
#.#.#.....#...#...##
#.#.#####.###.#.####
#.#...#.......#...##
#.###.###########..#
#...#...........##.#
#.#.#####.#####.#..#
#.#.#...#.....#...##
#.#.#.#.#.###.######
#.#...#..A..#.....##
####################

