Ow, o curso eh top
####################
#S..#C............##
###.#####.#######.##
#.#.....#.#.....#.##
#.#####.#.#.#####..#
#.......#...#...##.#
#.###########.#....#
#.#.........#.#.##.#
#.#.#####.#.#.#.#..#
#.#.#...#.#.#.#.#.##
#.###.#.#.#.#.#.#.##
#...#.#...#...#...##
###.#.#########..###
#...#.#.......#....#
#.###.#.#####.####.#
#....A#.#...#B.....#
#######.#.#.########
#.........#........#
####################

