Desculpa, menos alguns segundos
###################
#S#.....#.........#
#.#.#.#.#.#######.#
#.#.#.#...#...#...#
#.###.#####.#.#.###
#.....#...#C#.#...#
#######.#.###.###.#
#.......#.....#...#
#.#.#####.#####.###
#.#.....#.#...#.#.#
#.#####.###.#.#.#.#
#....B#...#.#...#.#
#.#######.#.#####.#
#.#.......#.#.....#
#.#.#######.#.#.#.#
#.#.#.....#.#A#.#.#
#.#.#.###.#.###.#.#
#.#.....#.......#.#
###################

