Voces nao tinham que chegar ate aqui, mas... parabens!
####################
#B.................#
#.......#..........#
#.......#..........#
#.......#########..#
#.......#..........#
#....####..........#
#.............###..#
#.............###..#
#....#....S...###..#
#...##.............#
#..................#
#########.....##...#
#C......#.....##...#
#....##.#..........#
#.#.....#.....######
#####...#...#.#...##
#.......#...#.#.#.##
#...........#...#A##
####################

