Belo trabalho em equipe!
####################
#S....#............#
#.....#............#
#.....#..###.......#
#.....#........#...#
##.####....A...#...#
#.....#........#...#
#.....#.......#....#
#............###...#
#........#....#....#
#.......###........#
#........#B........#
#..................#
#..#...............#
#.###........#.....#
#..#........###....#
#..#.......#####...#
#.###.......###....#
#..#.........#C....#
####################
