Acreditem no potencial de voces!
####################
#.....####......#..#
#.B.#..###..#..###.#
#####...##.###..#..#
#......###..#......#
#.....####.........#
#.########.....#...#
#......#.#....###..#
#......#.#...#####.#
#......#......###..#
#....###.#.....#...#
#.####...#.........#
#....##..#.#.......#
#.....#..#.#######.#
#........#.#.......#
#........#.#.#######
#.#####..#.#.......#
#........#.#######.#
#C.......#A#S......#
####################
