Boa sorte no processo seletivo!
####################
#C..#.....#..#...#S#
#...#..#.###.#.#.#.#
#.###.###.#..#.#.#.#
#......#.....#.#.#.#
##.#####..#..#.#.#.#
#.........#..#.#.#.#
########..#..#.#...#
#..........###.#####
##########.#.......#
#..........#.##.##.#
#.##....##.#...A...#
#....#B#...#.##.##.#
#.##....##.#.......#
#..........#..###..#
#..........#.......#
#..############.####
#...........#...####
#.........#...#.####
####################
