Is that a jojo's reference?
####################
#C#...............B#
#.#..#####...###...#
#.#....#....#...#..#
#......#....#...#..#
#..#...#....#...#..#
#...###......###...#
#....#######...#...#
####...........#...#
#A.####....#########
#.....###......#...#
#.....#........#...#
#####..............#
#....#####...###...#
#......#....#...#..#
#......#....#...#..#
#..#...#....#...#..#
#...###......###S..#
#..................#
####################
